R 900 600
NO ./textures/image_n.xpm
SO ./textures/image_s.xpm
WE ./textures/image_w.xpm
EA ./textures/image_e.xpm
S ./textures/sprite.xpm
F 255, 255, 255
C 0, 0, 255

11111111111111111111
12100000000000000021
12100002000000000001
12100000000002000001
10000000000000020001
120000000N0000000001
10000000000000200001
10000002000000000001
10000000000000000001
11111111111111111111
