

NO ./image_n.xpm
SO ./image_s.xpm
WE ./image_w.xpm
EA ./image_e.xpm
S ./sprite.xpm
F 255,255,255
C 0,0,255

               1
               1
        1111111111111111111111111
        1000000000110000000000001
        1011000001110000002000001
        1001000000000000000000001
111 11111011000001110000000000001
101 10000011000001110111111111111
11111111111111011100000000001
11110111111111011101010010001    11111
11000001110101011100000010001    10001
100020000000000011000000100011   10001
10000000000000001101010010001    10001
11000001110101011111011110N01    11111
1111011111110101 101111010001
11111111 1111111 111111111111
