        1111111111111111111111111
        1000000000110002000002001
        1011000001110000002200001
        100100N000000000200200001
111111111011000001110000000200001
100000000011000001110101111111111
11110111111111011100001010001
11110111111111011101010010001
11000000110101011100000010001
10001000000000001100000010001
10000000000000001101010010001
1100000111010101111101111000111
11110111 1110101 101111010001
11111111 1111111 111111111111
