1111111
100000111
100000001
100N00001
100010001
100001111
1111111
