111111111111111
100000000000021
102000020200011
100020002002001
100N00002000011
100200200200001
120000200020011
100020000000021
111111111111111
