R 900 600
NO ./image_n.xpm
SO ./image_s.xpm
WE ./image_w.xpm
EA ./image_e.xpm
S ./sprite.xpm
F 255,255,255
C 0,0,255



1111
1N11
1111
