111111111111111
101010101010101
100000000000001
100000000000001
100000020000001
100000000000001
10000N000000001
100000000000001
111111111111111
