R 900 600
NO ./image_n.xpm
SO ./image_s.xpm
WE ./image_w.xpm
EA ./image_e.xpm
S ./sprite.xpm
F 255,255,255
C 0,0,255



11111111111111111111
10000000000000000001
10000002000000000001
10000000000002000001
10000000200000020001
102000000N0000000001
10000000000000200001
10000002000000000001
10000000000000000001
11111111111111111111
